mankind	people, human beings, humanity
freshman	first-year student
man-made	machine-made, synthetic, artificial
the common man	the average person
chairman	chair, chairperson, coordinator, head
mailman	mail carrier, letter carrier, postal worker
policeman	police officer
steward	flight attendant
stewardess	flight attendant
actress	actor
congressman	legislator, congressional representative
Dear Sir or Madam	To Whom it May Concernactive

Sprachwissenschaftler	Sprachwissenschaftler_innen, Sprachwissenschaftler*innen
Student	Studierende, Student_innen, Student*innen
Chef	Führungskraft, Chef_in, Chef*in
Chefs	Führungskräfte, Chef_innen, Chef*innne
Piloten	Menschen die das Flugzeuf fliegen, Pilot_innen, Pilot*innen
Bauern	Landwirt_innen, Landwirt*innen, Bäuer_innen, Bäuer*innen
Professoren	Professor_innen, Professor*innen
Polizisten	Polizist_innen, Polizist*innen
Autoren	Autor_innen, Autor*innen
Psychologen	Psycholog_innen, Psycholog*innen
Journalisten	Journalist_innen, Journalist*innen
Moderatoren	Moderator_innen, Moderator*innen
Pianisten	Pianist_innen, Pianist*innen
Gitarristen	Gitarrist_innen, Gitarrist*innen
Direktoren	Diktator_innen, Diktator*innen
Köche	Menschen die kochen, Köch_innen, Köch*innen
Matrosen	Menschen die zur See fahren, Menschen die auf einem Schiff arbeiten, Matros_innen, Matros*innen
Kapitäne	Kapitän_innen, Kapitän*innen
Kommissare	Kommissar_innen, Kommissar*innen
Ärzte	Mediziner_innen, Mediziner*innen, Ärzt_innen, Ärzt*innen
Doktoren	Doktor_innen, Doktor*innen
Astronauten	Astronaut_innen, Astronaut*innen
Piraten	Pirat_innen, Pirat*innen
Helden	Held_innen, Held*innen
Held	Held_in, Held*in
Soldaten	Soldat_innen, Soldat*innen
Sekretäre	Sekretär_innen, Sekretär*innen
Sekretärin	Sekretär_in, Sekretär*in
Sekretärinnen	Sekretär_innen, Sekretär*innen
Anwälte	Anwält_innen, Anwält*innen
Athleten	Athlet_innen, Athlet*innen
Bosse	Führungskräfte
Theologen	Theolog_innen, Theolog*innen
Spione	Spion_innen, Spion*innen
Terroristen	Terrorist_innen, Terrorist*innen
Stadträte	Stadträt_innen, Stadträdt*innen
Senatoren	Senator_innen, Senator*innen
Sklaven	Sklav_innen, Sklav*innen
Investor	Investor_innen, Investor*innen
Kunden	Menschen die etwas kaufen, Kund_innen, Kund*innen
Praktikanten	Praktikant_innen, Praktikant*innen
Teilnehmer	Teilnehmende, Teilnehmer_innen, Teilnehmer*innen
Mentoren	Mentor_innen, Mentor*innen
Feuerwehrmann	Feuerwehrkraft
Feuerwehrmänner	Feuerwehrkräfte
Studenten	Studierenden, Student_innen, Student*innen
Bürger	Bürger_innen, Bürger*innen
Politiker	Politiker_innen, Politiker*innen
Mörder	Mörder_innen, Mörder*innen
Täter	Täter_innen, Täter*innen
Mitarbeiter	Mitarbeiter_innen, Mitarbeiter*innen
Schüler	Schüler_innen, Schüler*innen
Designer	Designer_innen, Designer*innen
Programmierer	Programmierer_innen, Programmierer*innen
Entwickler	Entwickler_innen, Entwickler*innen
Techniker	Techniker_innen, Techniker*innen
Informatiker	Informatiker_innen, Informatiker*innen
Geschäftsführer	Geschäftsführer_innen, Geschäftsführer*innen
Gründer	Gründende, Gründer_innen, Gründer*innen
Erzieher	Erziehende, Erzieher_innen, Erzieher*innen
Fahrer	Fahrer_innen, Fahrer*innen
Bauarbeiter	Bauarbeiter_innen, Bauarbeiter*innen
Klempner	Klempner_innen, Klempner*innen
Musiker	Musiker_innen, Musiker*innen
Nutzer	Nutzer_innen, Nutzer*innen
User	User_innen, User*innen
Developer	Developer_innen, Developer*innen
Leiter	Leiter_innen, Leiter*innen
Schulleiter	Schulleiter_innen, Schulleiter*innen
Wähler	Wähler_innen, Wähler*innen
Pfleger	Pfleger_innen, Pfleger*innen
Ritter	Ritter_innen, Ritter*innen
Sanitäter	Sanitäter_innen, Sanitäter*innen
Sprecher	Sprecher_innen, Sprecher*innen
Manager	Manager_innen, Manager*innen
Sänger	Sänger_innen, Sänger*innen
Künstler	Künstler_innen, Künstler*innen
Berater	Berater_innen, Berater*innen
Arbeiter	Arbeiter_innen, Arbeiter*innen
Sexarbeiter	Sexarbeiter_innen, Sexarbeiter*innen
Apotheker	Apotheker_innen, Apotheker*innen
Kindergärtner	Kindergärtner_innen, Kindergärtner*innen
Wissenschaftler	Wissenschaftler_innen, Wissenschaftler*innen
Forscher	Forscher_innen, Forscher*innen
Räuber	Räuber_innen, Räuber*innen
Vergewaltiger	Vergewaltiger_innen, Vergewaltiger*innen
Verbrecher	Verbrecher_innen, Verbrecher*innen
Richter	Richter_innen, Richter*innen
Sportler	Sportler_innen, Sportler*innen
Gärtner	Gärtner_innen, Gärtner*innen
Retter	Retter_innen, Retter*innen
Handwerker	Handwerker_innen, Handwerker*innen
Maurer	Maurer_innen, Maurer*innen
Führer	Führer_innen, Führer*innen
Vertreter	Vertreter_innen, Vertreter*innen
Vertriebler	Vertriebler_innen, Vertriebler*innen
Förster	Förster_innen, Förster*innen
Jäger	Jäger_innen, Jäger*innen
Minister	Minister_innen, Minister*innen
Fleischer	Fleischer_innen, Fleischer*innen
Bäcker	Bäcker_innen, Bäcker*innen
Schriftsteller	Schriftsteller_innen, Schriftsteller*innen
Tischler	Tischler_innen, Tischler*innen
Meister	Meister_innen, Meister*innen
Reporter	Reporter_innen, Reporter*innen
Glaser	Glaser_innen, Glaser*innen
Wächter	Wächter_innen, Wächter*innen
Trinker	Trinker_innen, Trinker*innen
Träger	Träger_innen, Träger*innen
Geldgeber	Geldgeber_innen, Geldgeber*innen
Kontoinhaber	Kontoinhaber_innen, Kontoinhaber*innen
Antragssteller	Antragssteller_innen, Antragssteller*innen
Inhaber	Inhaber_innen, Inhaber*innen
Barkeeper	Barkeeper_innen, Barkeeper*innen
Kellner	Kellner_innen, Kellner*innen
Leser	Leser_innen, Leser*innen
Zuhörer	Zuhörer_innen, Zuhörer*innen
Zuschauer	Zuschauer_innen, Zuschauer*innen
YouTuber	YouTuber_innen, YouTuber*innen
Gamer	Gamer_innen, Gamer*innen
Netzwerker	Netzwerker_innen, Netzwerker*innen
Spieler	Spieler_innen, Spieler*innen
Speaker	Speaker_innen, Speaker*innen
Redner	Redner_innen, Redner*innen
Unterstützer	Unterstützer_innen, Unterstützer*innen
Trainer	Trainer_innen, Trainer*innen
Schauspieler	Schauspieler_innen, Schauspieler*innen
Sehr geehrte Damen und Herren	Sehr geehrtes Publikum, Sehr geehrte Menschen
Liebe Damen und Herren	Liebe Leute


die Lehrer	die Lehrkräfte, die Lehrer_innen, die Lehrer*innen
Lehrer	Lehrkraft, Lehrer_in, Lehrer*in, Lehrkräfte, Lehrer_innen, Lehrer*innen
Patient	Patient_in, Patient*in
Patienten	Patient_innen, Patient*innen, Menschen in Behandlung
Die Patienten	Die Patient_innen, Die Patient*innen, Die Menschen in Behandlung
die Patienten	die Patient_innen, die Patient*innen, die Menschen in Behandlung
Liebe Patienten	Liebe Patient_innen, Liebe Patient*innen
alle Patienten	alle Patient_innen, alle Patient*innen, alle Menschen in Behandlung
diese Patienten	diese Patient_innen, diese Patient*innen
solche Patienten	solche Patient_innen, solche Patient*innen
Ärzte	Ärzt_innen, Ärzt*innen, Medizinier_innen, Mediziner*innen
Liebe Ärzte	Liebe Ärzt_innen, Liebe Ärzt*innen, Liebe Medizinier_innen, Liebe Medizinier*innen
alle Ärzte	alle Ärzt_innen, alle Ärzt*innen, alle Medizinier_innen, alle Medizinier*innen
die Ärzte	die Ärzt_innen, die Ärzt*innen, die Medizinier_innen, die Medizinier*innen
Die Ärzte	Die Ärzt_innen, Die Ärzt*innen, Die Medizinier_innen, Die Medizinier*innen
Chefärzte	Chefärzt_innen, Chefärzt*innen, leitenden Medizinier_innen, leitenden Mediziner*innen
Liebe Chefärzte	Liebe Chefärzt_innen, Liebe Chefärzt*innen, Liebe leitenden Medizinier_innen, Liebe leitenden Medizinier*innen
alle Chefärzte	alle Chefärzt_innen, alle Chefärzt*innen, alle leitenden Medizinier_innen, alle leitenden Medizinier*innen
die Chefärzte	die Chefärzt_innen, die Chefärzt*innen, die leitenden Medizinier_innen, die leitenden Medizinier*innen
Die Chefärzte	Die Chefärzt_innen, Die Chefärzt*innen, Die leitenden Medizinier_innen, Die leitenden Medizinier*innen
Chefarztbehandlung	Behandlung durch die Stationsleitung
Krankenschwester 	Pflegekraft, Krankenpfleger_in, Krankenpfleger*in
Krankenschwestern	Pflegekräfte, Krankenpflegende, Krankenpfleger_innen, Krankenpfleger*innen
Schauspieler	Schauspieler_innen, Schauspieler*innen
die Bürger	die Bürger_innen, die Bürger*innen
die Politiker	die Politiker_innen, die Politiker*innen
die Mörder	die Mörder_innen, die Mörder*innen
die Täter	die Täter_innen, die Täter*innen
die Mitarbeiter	die Mitarbeiter_innen, die Mitarbeiter*innen
die Schüler	die Schüler_innen, die Schüler*innen
die Designer	die Designer_innen, die Designer*innen
die Programmierer	die Programmierer_innen, die Programmierer*innen
die Entwickler	die Entwickler_innen, die Entwickler*innen
die Techniker	die Techniker_innen, die Techniker*innen
die Informatiker	die Informatiker_innen, die Informatiker*innen
die Geschäftsführer	die Geschäftsführer_innen, die Geschäftsführer*innen
die Gründer	die Gründer_innen, die Gründer*innen
die Erzieher	die Erzieher_innen, die Erzieher*innen
die Fahrer	die Fahrer_innen, die Fahrer*innen
die Bauarbeiter	die Bauarbeiter_innen, die Bauarbeiter*innen
die Klempner	die Klempner_innen, die Klempner*innen
die Musiker	die Musiker_innen, die Musiker*innen
die Nutzer	die Nutzer_innen, die Nutzer*innen
die User	die User_innen, die User*innen
die Developer	die Developer_innen, die Developer*innen
die Leiter	die Leiter_innen, die Leiter*innen
die Schulleiter	die Schulleiter_innen, die Schulleiter*innen
die Wähler	die Wähler_innen, die Wähler*innen
die Pfleger	die Pfleger_innen, die Pfleger*innen
die Ritter	die Ritter_innen, die Ritter*innen
die Sanitäter	die Sanitäter_innen, die Sanitäter*innen
die Sprecher	die Sprecher_innen, die Sprecher*innen
die Manager	die Manager_innen, die Manager*innen
die Sänger	die Sänger_innen, die Sänger*innen
die Küntler	die Küntler_innen, die Küntler*innen
die Berater	die Berater_innen, die Berater*innen
die Arbeiter	die Arbeiter_innen, die Arbeiter*innen
die Sexarbeiter	die Sexarbeiter_innen, die Sexarbeiter*innen
die Apotheker	die Apotheker_innen, die Apotheker*innen
die Kindergärtner	die Kindergärtner_innen, die Kindergärtner*innen
die Wissenschaftler	die Wissenschaftler_innen, die Wissenschaftler*innen
die Forscher	die Forscher_innen, die Forscher*innen
die Räuber	die Räuber_innen, die Räuber*innen
die Vergewaltiger	die Vergewaltiger_innen, die Vergewaltiger*innen
die Verbrecher	die Verbrecher_innen, die Verbrecher*innen
die Richter	die Richter_innen, die Richter*innen
die Sportler	die Sportler_innen, die Sportler*innen
die Gärtner	die Gärtner_innen, die Gärtner*innen
die Retter	die Retter_innen, die Retter*innen
die Handwerker	die Handwerker_innen, die Handwerker*innen
die Maurer	die Maurer_innen, die Maurer*innen
die Führer	die Führer_innen, die Führer*innen
die Vertreter	die Vertreter_innen, die Vertreter*innen
die Vertriebler	die Vertriebler_innen, die Vertriebler*innen
die Förster	die Förster_innen, die Förster*innen
die Jäger	die Jäger_innen, die Jäger*innen
die Minister	die Minister_innen, die Minister*innen
die Fleischer	die Fleischer_innen, die Fleischer*innen
die Bäcker	die Bäcker_innen, die Bäcker*innen
die Schriftsteller	die Schriftsteller_innen, die Schriftsteller*innen
die Tischler	die Tischler_innen, die Tischler*innen
die Meister	die Meister_innen, die Meister*innen
die Reporter	die Reporter_innen, die Reporter*innen
die Gläser	die Gläser_innen, die Gläser*innen
die Wächter	die Wächter_innen, die Wächter*innen
die Trinker	die Trinker_innen, die Trinker*innen
die Träger	die Träger_innen, die Träger*innen
die Geldgeber	die Geldgeber_innen, die Geldgeber*innen
die Kontoinhaber	die Kontoinhaber_innen, die Kontoinhaber*innen
die Antragssteller	die Antragssteller_innen, die Antragssteller*innen
die Inhaber	die Inhaber_innen, die Inhaber*innen
die Barkeeper	die Barkeeper_innen, die Barkeeper*innen
die Kellner	die Kellner_innen, die Kellner*innen
die Leser	die Leser_innen, die Leser*innen
die Zuhörer	die Zuhörer_innen, die Zuhörer*innen
die Zuschauer	die Zuschauer_innen, die Zuschauer*innen
die YouTuber	die YouTuber_innen, die YouTuber*innen
die Gamer	die Gamer_innen, die Gamer*innen
die Netzwerker	die Netzwerker_innen, die Netzwerker*innen
die Spieler	die Spieler_innen, die Spieler*innen
die Speaker	die Speaker_innen, die Speaker*innen
die Redner	die Redner_innen, die Redner*innen
die Unterstützer	die Unterstützer_innen, die Unterstützer*innen
die Trainer	die Trainer_innen, die Trainer*innen
die Schauspieler	die Schauspieler_innen, die Schauspieler*innen


Liebe Bürger	Liebe Bürger_innen, Liebe Bürger*innen
Liebe Politiker	Liebe Politiker_innen, Liebe Politiker*innen
Liebe Mörder	Liebe Mörder_innen, Liebe Mörder*innen
Liebe Täter	Liebe Täter_innen, Liebe Täter*innen
Liebe Mitarbeiter	Liebe Mitarbeiter_innen, Liebe Mitarbeiter*innen
Liebe Schüler	Liebe Schüler_innen, Liebe Schüler*innen
Liebe Designer	Liebe Designer_innen, Liebe Designer*innen
Liebe Programmierer	Liebe Programmierer_innen, Liebe Programmierer*innen
Liebe Entwickler	Liebe Entwickler_innen, Liebe Entwickler*innen
Liebe Techniker	Liebe Techniker_innen, Liebe Techniker*innen
Liebe Informatiker	Liebe Informatiker_innen, Liebe Informatiker*innen
Liebe Geschäftsführer	Liebe Geschäftsführer_innen, Liebe Geschäftsführer*innen
Liebe Gründer	Liebe Gründenden, Liebe Gründer_innen, Liebe Gründer*innen
Liebe Erzieher	Liebe Erzieher_innen, Liebe Erzieher*innen
Liebe Fahrer	Liebe Fahrer_innen, Liebe Fahrer*innen
Liebe Bauarbeiter	Liebe Bauarbeiter_innen, Liebe Bauarbeiter*innen
Liebe Klempner	Liebe Klempner_innen, Liebe Klempner*innen
Liebe Musiker	Liebe Musiker_innen, Liebe Musiker*innen
Liebe Nutzer	Liebe Nutzer_innen, Liebe Nutzer*innen
Liebe User	Liebe User_innen, Liebe User*innen
Liebe Developer	Liebe Developer_innen, Liebe Developer*innen
Liebe Leiter	Liebe Leiter_innen, Liebe Leiter*innen
Liebe Schulleiter	Liebe Schulleiter_innen, Liebe Schulleiter*innen
Liebe Wähler	Liebe Wähler_innen, Liebe Wähler*innen
Liebe Pfleger	Liebe Pfleger_innen, Liebe Pfleger*innen
Liebe Ritter	Liebe Ritter_innen, Liebe Ritter*innen
Liebe Sanitäter	Liebe Sanitäter_innen, Liebe Sanitäter*innen
Liebe Sprecher	Liebe Sprecher_innen, Liebe Sprecher*innen
Liebe Manager	Liebe Manager_innen, Liebe Manager*innen
Liebe Sänger	Liebe Sänger_innen, Liebe Sänger*innen
Liebe Küntler	Liebe Küntler_innen, Liebe Küntler*innen
Liebe Berater	Liebe Berater_innen, Liebe Berater*innen
Liebe Arbeiter	Liebe Arbeiter_innen, Liebe Arbeiter*innen
Liebe Sexarbeiter	Liebe Sexarbeiter_innen, Liebe Sexarbeiter*innen
Liebe Apotheker	Liebe Apotheker_innen, Liebe Apotheker*innen
Liebe Kindergärtner	Liebe Kindergärtner_innen, Liebe Kindergärtner*innen
Liebe Wissenschaftler	Liebe Wissenschaftler_innen, Liebe Wissenschaftler*innen
Liebe Forscher	Liebe Forscher_innen, Liebe Forscher*innen
Liebe Räuber	Liebe Räuber_innen, Liebe Räuber*innen
Liebe Vergewaltiger	Liebe Vergewaltiger_innen, Liebe Vergewaltiger*innen
Liebe Verbrecher	Liebe Verbrecher_innen, Liebe Verbrecher*innen
Liebe Richter	Liebe Richter_innen, Liebe Richter*innen
Liebe Sportler	Liebe Sportler_innen, Liebe Sportler*innen
Liebe Gärtner	Liebe Gärtner_innen, Liebe Gärtner*innen
Liebe Retter	Liebe Retter_innen, Liebe Retter*innen
Liebe Handwerker	Liebe Handwerker_innen, Liebe Handwerker*innen
Liebe Maurer	Liebe Maurer_innen, Liebe Maurer*innen
Liebe Führer	Liebe Führer_innen, Liebe Führer*innen
Liebe Vertreter	Liebe Vertreter_innen, Liebe Vertreter*innen
Liebe Vertriebler	Liebe Vertriebler_innen, Liebe Vertriebler*innen
Liebe Förster	Liebe Förster_innen, Liebe Förster*innen
Liebe Jäger	Liebe Jäger_innen, Liebe Jäger*innen
Liebe Minister	Liebe Minister_innen, Liebe Minister*innen
Liebe Fleischer	Liebe Fleischer_innen, Liebe Fleischer*innen
Liebe Bäcker	Liebe Bäcker_innen, Liebe Bäcker*innen
Liebe Schriftsteller	Liebe Schriftsteller_innen, Liebe Schriftsteller*innen
Liebe Tischler	Liebe Tischler_innen, Liebe Tischler*innen
Liebe Meister	Liebe Meister_innen, Liebe Meister*innen
Liebe Reporter	Liebe Reporter_innen, Liebe Reporter*innen
Liebe Gläser	Liebe Gläser_innen, Liebe Gläser*innen
Liebe Wächter	Liebe Wächter_innen, Liebe Wächter*innen
Liebe Trinker	Liebe Trinker_innen, Liebe Trinker*innen
Liebe Träger	Liebe Träger_innen, Liebe Träger*innen
Liebe Geldgeber	Liebe Geldgeber_innen, Liebe Geldgeber*innen
Liebe Kontoinhaber	Liebe Kontoinhaber_innen, Liebe Kontoinhaber*innen
Liebe Antragssteller	Liebe Antragssteller_innen, Liebe Antragssteller*innen
Liebe Inhaber	Liebe Inhaber_innen, Liebe Inhaber*innen
Liebe Barkeeper	Liebe Barkeeper_innen, Liebe Barkeeper*innen
Liebe Kellner	Liebe Kellner_innen, Liebe Kellner*innen
Liebe Leser	Liebe Leser_innen, Liebe Leser*innen
Liebe Zuhörer	Liebe Zuhörer_innen, Liebe Zuhörer*innen
Liebe Zuschauer	Liebe Zuschauer_innen, Liebe Zuschauer*innen
Liebe YouTuber	Liebe YouTuber_innen, Liebe YouTuber*innen
Liebe Gamer	Liebe Gamer_innen, Liebe Gamer*innen
Liebe Netzwerker	Liebe Netzwerker_innen, Liebe Netzwerker*innen
Liebe Spieler	Liebe Spieler_innen, Liebe Spieler*innen
Liebe Speaker	Liebe Speaker_innen, Liebe Speaker*innen
Liebe Redner	Liebe Redner_innen, Liebe Redner*innen
Liebe Unterstützer	Liebe Unterstützer_innen, Liebe Unterstützer*innen
Liebe Trainer	Liebe Trainer_innen, Liebe Trainer*innen
Liebe Schauspieler	Liebe Schauspieler_innen, Liebe Schauspieler*innen


Sehr geehrte Bürger	Sehr geehrte Bürger_innen, Sehr geehrte Bürger*innen
Sehr geehrte Politiker	Sehr geehrte Politiker_innen, Sehr geehrte Politiker*innen
Sehr geehrte Mörder	Sehr geehrte Mörder_innen, Sehr geehrte Mörder*innen
Sehr geehrte Täter	Sehr geehrte Täter_innen, Sehr geehrte Täter*innen
Sehr geehrte Mitarbeiter	Sehr geehrte Mitarbeiter_innen, Sehr geehrte Mitarbeiter*innen
Sehr geehrte Schüler	Sehr geehrte Schüler_innen, Sehr geehrte Schüler*innen
Sehr geehrte Designer	Sehr geehrte Designer_innen, Sehr geehrte Designer*innen
Sehr geehrte Programmierer	Sehr geehrte Programmierer_innen, Sehr geehrte Programmierer*innen
Sehr geehrte Entwickler	Sehr geehrte Entwickler_innen, Sehr geehrte Entwickler*innen
Sehr geehrte Techniker	Sehr geehrte Techniker_innen, Sehr geehrte Techniker*innen
Sehr geehrte Informatiker	Sehr geehrte Informatiker_innen, Sehr geehrte Informatiker*innen
Sehr geehrte Geschäftsführer	Sehr geehrte Geschäftsführer_innen, Sehr geehrte Geschäftsführer*innen
Sehr geehrte Gründer	Sehr geehrte Gründer_innen, Sehr geehrte Gründer*innen
Sehr geehrte Erzieher	Sehr geehrte Erzieher_innen, Sehr geehrte Erzieher*innen
Sehr geehrte Fahrer	Sehr geehrte Fahrer_innen, Sehr geehrte Fahrer*innen
Sehr geehrte Bauarbeiter	Sehr geehrte Bauarbeiter_innen, Sehr geehrte Bauarbeiter*innen
Sehr geehrte Klempner	Sehr geehrte Klempner_innen, Sehr geehrte Klempner*innen
Sehr geehrte Musiker	Sehr geehrte Musiker_innen, Sehr geehrte Musiker*innen
Sehr geehrte Nutzer	Sehr geehrte Nutzer_innen, Sehr geehrte Nutzer*innen
Sehr geehrte User	Sehr geehrte User_innen, Sehr geehrte User*innen
Sehr geehrte Developer	Sehr geehrte Developer_innen, Sehr geehrte Developer*innen
Sehr geehrte Leiter	Sehr geehrte Leiter_innen, Sehr geehrte Leiter*innen
Sehr geehrte Schulleiter	Sehr geehrte Schulleiter_innen, Sehr geehrte Schulleiter*innen
Sehr geehrte Wähler	Sehr geehrte Wähler_innen, Sehr geehrte Wähler*innen
Sehr geehrte Pfleger	Sehr geehrte Pfleger_innen, Sehr geehrte Pfleger*innen
Sehr geehrte Ritter	Sehr geehrte Ritter_innen, Sehr geehrte Ritter*innen
Sehr geehrte Sanitäter	Sehr geehrte Sanitäter_innen, Sehr geehrte Sanitäter*innen
Sehr geehrte Sprecher	Sehr geehrte Sprecher_innen, Sehr geehrte Sprecher*innen
Sehr geehrte Manager	Sehr geehrte Manager_innen, Sehr geehrte Manager*innen
Sehr geehrte Sänger	Sehr geehrte Sänger_innen, Sehr geehrte Sänger*innen
Sehr geehrte Küntler	Sehr geehrte Küntler_innen, Sehr geehrte Küntler*innen
Sehr geehrte Berater	Sehr geehrte Berater_innen, Sehr geehrte Berater*innen
Sehr geehrte Arbeiter	Sehr geehrte Arbeiter_innen, Sehr geehrte Arbeiter*innen
Sehr geehrte Sexarbeiter	Sehr geehrte Sexarbeiter_innen, Sehr geehrte Sexarbeiter*innen
Sehr geehrte Apotheker	Sehr geehrte Apotheker_innen, Sehr geehrte Apotheker*innen
Sehr geehrte Kindergärtner	Sehr geehrte Kindergärtner_innen, Sehr geehrte Kindergärtner*innen
Sehr geehrte Wissenschaftler	Sehr geehrte Wissenschaftler_innen, Sehr geehrte Wissenschaftler*innen
Sehr geehrte Forscher	Sehr geehrte Forscher_innen, Sehr geehrte Forscher*innen
Sehr geehrte Räuber	Sehr geehrte Räuber_innen, Sehr geehrte Räuber*innen
Sehr geehrte Vergewaltiger	Sehr geehrte Vergewaltiger_innen, Sehr geehrte Vergewaltiger*innen
Sehr geehrte Verbrecher	Sehr geehrte Verbrecher_innen, Sehr geehrte Verbrecher*innen
Sehr geehrte Richter	Sehr geehrte Richter_innen, Sehr geehrte Richter*innen
Sehr geehrte Sportler	Sehr geehrte Sportler_innen, Sehr geehrte Sportler*innen
Sehr geehrte Gärtner	Sehr geehrte Gärtner_innen, Sehr geehrte Gärtner*innen
Sehr geehrte Retter	Sehr geehrte Retter_innen, Sehr geehrte Retter*innen
Sehr geehrte Handwerker	Sehr geehrte Handwerker_innen, Sehr geehrte Handwerker*innen
Sehr geehrte Maurer	Sehr geehrte Maurer_innen, Sehr geehrte Maurer*innen
Sehr geehrte Führer	Sehr geehrte Führer_innen, Sehr geehrte Führer*innen
Sehr geehrte Vertreter	Sehr geehrte Vertreter_innen, Sehr geehrte Vertreter*innen
Sehr geehrte Vertriebler	Sehr geehrte Vertriebler_innen, Sehr geehrte Vertriebler*innen
Sehr geehrte Förster	Sehr geehrte Förster_innen, Sehr geehrte Förster*innen
Sehr geehrte Jäger	Sehr geehrte Jäger_innen, Sehr geehrte Jäger*innen
Sehr geehrte Minister	Sehr geehrte Minister_innen, Sehr geehrte Minister*innen
Sehr geehrte Fleischer	Sehr geehrte Fleischer_innen, Sehr geehrte Fleischer*innen
Sehr geehrte Bäcker	Sehr geehrte Bäcker_innen, Sehr geehrte Bäcker*innen
Sehr geehrte Schriftsteller	Sehr geehrte Schriftsteller_innen, Sehr geehrte Schriftsteller*innen
Sehr geehrte Tischler	Sehr geehrte Tischler_innen, Sehr geehrte Tischler*innen
Sehr geehrte Meister	Sehr geehrte Meister_innen, Sehr geehrte Meister*innen
Sehr geehrte Reporter	Sehr geehrte Reporter_innen, Sehr geehrte Reporter*innen
Sehr geehrte Gläser	Sehr geehrte Gläser_innen, Sehr geehrte Gläser*innen
Sehr geehrte Wächter	Sehr geehrte Wächter_innen, Sehr geehrte Wächter*innen
Sehr geehrte Trinker	Sehr geehrte Trinker_innen, Sehr geehrte Trinker*innen
Sehr geehrte Träger	Sehr geehrte Träger_innen, Sehr geehrte Träger*innen
Sehr geehrte Geldgeber	Sehr geehrte Geldgeber_innen, Sehr geehrte Geldgeber*innen
Sehr geehrte Kontoinhaber	Sehr geehrte Kontoinhaber_innen, Sehr geehrte Kontoinhaber*innen
Sehr geehrte Antragssteller	Sehr geehrte Antragssteller_innen, Sehr geehrte Antragssteller*innen
Sehr geehrte Inhaber	Sehr geehrte Inhaber_innen, Sehr geehrte Inhaber*innen
Sehr geehrte Barkeeper	Sehr geehrte Barkeeper_innen, Sehr geehrte Barkeeper*innen
Sehr geehrte Kellner	Sehr geehrte Kellner_innen, Sehr geehrte Kellner*innen
Sehr geehrte Leser	Sehr geehrte Leser_innen, Sehr geehrte Leser*innen
Sehr geehrte Zuhörer	Sehr geehrte Zuhörer_innen, Sehr geehrte Zuhörer*innen
Sehr geehrte Zuschauer	Sehr geehrte Zuschauer_innen, Sehr geehrte Zuschauer*innen
Sehr geehrte YouTuber	Sehr geehrte YouTuber_innen, Sehr geehrte YouTuber*innen
Sehr geehrte Gamer	Sehr geehrte Gamer_innen, Sehr geehrte Gamer*innen
Sehr geehrte Netzwerker	Sehr geehrte Netzwerker_innen, Sehr geehrte Netzwerker*innen
Sehr geehrte Spieler	Sehr geehrte Spieler_innen, Sehr geehrte Spieler*innen
Sehr geehrte Speaker	Sehr geehrte Speaker_innen, Sehr geehrte Speaker*innen
Sehr geehrte Redner	Sehr geehrte Redner_innen, Sehr geehrte Redner*innen
Sehr geehrte Unterstützer	Sehr geehrte Unterstützer_innen, Sehr geehrte Unterstützer*innen
Sehr geehrte Trainer	Sehr geehrte Trainer_innen, Sehr geehrte Trainer*innen
Sehr geehrte Schauspieler	Sehr geehrte Schauspieler_innen, Sehr geehrte Schauspieler*innen


alle Bürger	alle Bürger_innen, alle Bürger*innen
alle Politiker	alle Politiker_innen, alle Politiker*innen
alle Mörder	alle Mörder_innen, alle Mörder*innen
alle Täter	alle Täter_innen, alle Täter*innen
alle Mitarbeiter	alle Mitarbeiter_innen, alle Mitarbeiter*innen
alle Schüler	alle Schüler_innen, alle Schüler*innen
alle Designer	alle Designer_innen, alle Designer*innen
alle Programmierer	alle Programmierer_innen, alle Programmierer*innen
alle Entwickler	alle Entwickler_innen, alle Entwickler*innen
alle Techniker	alle Techniker_innen, alle Techniker*innen
alle Informatiker	alle Informatiker_innen, alle Informatiker*innen
alle Geschäftsführer	alle Geschäftsführer_innen, alle Geschäftsführer*innen
alle Gründer	alle Gründer_innen, alle Gründer*innen
alle Erzieher	alle Erzieher_innen, alle Erzieher*innen
alle Fahrer	alle Fahrer_innen, alle Fahrer*innen
alle Bauarbeiter	alle Bauarbeiter_innen, alle Bauarbeiter*innen
alle Klempner	alle Klempner_innen, alle Klempner*innen
alle Musiker	alle Musiker_innen, alle Musiker*innen
alle Nutzer	alle Nutzer_innen, alle Nutzer*innen
alle User	alle User_innen, alle User*innen
alle Developer	alle Developer_innen, alle Developer*innen
alle Leiter	alle Leiter_innen, alle Leiter*innen
alle Schulleiter	alle Schulleiter_innen, alle Schulleiter*innen
alle Wähler	alle Wähler_innen, alle Wähler*innen
alle Pfleger	alle Pfleger_innen, alle Pfleger*innen
alle Ritter	alle Ritter_innen, alle Ritter*innen
alle Sanitäter	alle Sanitäter_innen, alle Sanitäter*innen
alle Sprecher	alle Sprecher_innen, alle Sprecher*innen
alle Manager	alle Manager_innen, alle Manager*innen
alle Sänger	alle Sänger_innen, alle Sänger*innen
alle Küntler	alle Küntler_innen, alle Küntler*innen
alle Berater	alle Berater_innen, alle Berater*innen
alle Arbeiter	alle Arbeiter_innen, alle Arbeiter*innen
alle Sexarbeiter	alle Sexarbeiter_innen, alle Sexarbeiter*innen
alle Apotheker	alle Apotheker_innen, alle Apotheker*innen
alle Kindergärtner	alle Kindergärtner_innen, alle Kindergärtner*innen
alle Wissenschaftler	alle Wissenschaftler_innen, alle Wissenschaftler*innen
alle Forscher	alle Forscher_innen, alle Forscher*innen
alle Räuber	alle Räuber_innen, alle Räuber*innen
alle Vergewaltiger	alle Vergewaltiger_innen, alle Vergewaltiger*innen
alle Verbrecher	alle Verbrecher_innen, alle Verbrecher*innen
alle Richter	alle Richter_innen, alle Richter*innen
alle Sportler	alle Sportler_innen, alle Sportler*innen
alle Gärtner	alle Gärtner_innen, alle Gärtner*innen
alle Retter	alle Retter_innen, alle Retter*innen
alle Handwerker	alle Handwerker_innen, alle Handwerker*innen
alle Maurer	alle Maurer_innen, alle Maurer*innen
alle Führer	alle Führer_innen, alle Führer*innen
alle Vertreter	alle Vertreter_innen, alle Vertreter*innen
alle Vertriebler	alle Vertriebler_innen, alle Vertriebler*innen
alle Förster	alle Förster_innen, alle Förster*innen
alle Jäger	alle Jäger_innen, alle Jäger*innen
alle Minister	alle Minister_innen, alle Minister*innen
alle Fleischer	alle Fleischer_innen, alle Fleischer*innen
alle Bäcker	alle Bäcker_innen, alle Bäcker*innen
alle Schriftsteller	alle Schriftsteller_innen, alle Schriftsteller*innen
alle Tischler	alle Tischler_innen, alle Tischler*innen
alle Meister	alle Meister_innen, alle Meister*innen
alle Reporter	alle Reporter_innen, alle Reporter*innen
alle Gläser	alle Gläser_innen, alle Gläser*innen
alle Wächter	alle Wächter_innen, alle Wächter*innen
alle Trinker	alle Trinker_innen, alle Trinker*innen
alle Träger	alle Träger_innen, alle Träger*innen
alle Geldgeber	alle Geldgeber_innen, alle Geldgeber*innen
alle Kontoinhaber	alle Kontoinhaber_innen, alle Kontoinhaber*innen
alle Antragssteller	alle Antragssteller_innen, alle Antragssteller*innen
alle Inhaber	alle Inhaber_innen, alle Inhaber*innen
alle Barkeeper	alle Barkeeper_innen, alle Barkeeper*innen
alle Kellner	alle Kellner_innen, alle Kellner*innen
alle Leser	alle Leser_innen, alle Leser*innen
alle Zuhörer	alle Zuhörer_innen, alle Zuhörer*innen
alle Zuschauer	alle Zuschauer_innen, alle Zuschauer*innen
alle YouTuber	alle YouTuber_innen, alle YouTuber*innen
alle Gamer	alle Gamer_innen, alle Gamer*innen
alle Netzwerker	alle Netzwerker_innen, alle Netzwerker*innen
alle Spieler	alle Spieler_innen, alle Spieler*innen
alle Speaker	alle Speaker_innen, alle Speaker*innen
alle Redner	alle Redner_innen, alle Redner*innen
alle Unterstützer	alle Unterstützer_innen, alle Unterstützer*innen
alle Trainer	alle Trainer_innen, alle Trainer*innen
alle Schauspieler	alle Schauspieler_innen, alle Schauspieler*innen